##########
#    # . #
#   @    #
#  $     #
#        #
#        #
#    #   #
# .  # $ #
#    #   #
##########