##########
#  @   . #
#### # ###
#  $    .#
##     ###
#.     $ #
###      #
# .  #$$ #
#    #   #
##########