##########
#  @ # . #
#    #   #
#  $     #
###    $##
#.       #
#    #   #
# .  # $ #
#    #   #
##########